------------------------------------------------------------------------------------------------------
|                                                                                                    |
|                                                                                                    |
|           @                              @                                                         |
|           @                               @                                                        |
|           @                             @@@                                                        |
|                                                                                                    |
|                                                                                                    |
|                      @@@@                                                                          |
|                  @@           @@                                                                   |
|                        @@                                                                          |
|                                                                                                    |
|                                                                                                    |
|                                                    @@                                              |
|                                                  @@@@                                              |
|                                                    @@                                              |
|                                                                                                    |
|                                                                                                    |
|                                                                                                    |
|                                                                                                    |
|                                                                                                    |
|                                                                                                    |
|                                                                                                    |
|                                                                                                    |
|                                                                                                    |
|                                                                                                    |
------------------------------------------------------------------------------------------------------